111111111111111111111111111111111111
1P1000100000000000000000000000000001
101010101111111111111111111111111101
101010101000000000000000000000000101
101010101011111111111111111111110101
101010101010000000000000000000010101
101010101010111111111111111111010101
101010101010100000000000000001010101
101010101010101111111111111101010101
10101010101010100000000000E101010101
101010101010100000000000000101010101
101010101010111111111111111101010101
101010101010000000000000000001010101
101010101011111111111111111111010101
101010101000000000000000000000010101
101010101111111111111111111111110101
101010100000000000000000000000000101
101010111111111111111111111111111101
100010000000000CC0C00000000000000001
111111111111111111111111111111111111
111111111111111111111111111111111111
1P1000100000000000000000000000000001
101010101111111111111111111111111101
101010101000000000000000000000000101
101010101011111111111111111111110101
101010101010000000000000000000010101
101010101010111111111111111111010101
101010101010100000000000000001010101
101010101010101111111111111101010101
10101010101010100000000000E101010101
101010101010100000000000000101010101
101010101010111111111111111101010101
101010101010000000000000000001010101
101010101011111111111111111111010101
101010101000000000000000000000010101
101010101111111111111111111111110101
101010100000000000000000000000000101
101010111111111111111111111111111101
100010000000000CC0C00000000000000001
111111111111111111111111111111111111
111111111111111111111111111111111111
111111111111111111111111111111111111
111111111111111111111111111111111111
111111111111111111111111111111111111
111111111111111111111111111111111111
111111111111111111111111111111111111
111111111111111111111111111111111111
111111111111111111111111111111111111
111111111111111111111111111111111111
111111111111111111111111111111111111
111111111111111111111111111111111111
111111111111111111111111111111111111
111111111111111111111111111111111111
111111111111111111111111111111111111
111111111111111111111111111111111111
111111111111111111111111111111111111
111111111111111111111111111111111111
111111111111111111111111111111111111
111111111111111111111111111111111111
111111111111111111111111111111111111